8 10
1111111111
0111111110
1011001101
0000110000
0010110110
0110110100
0011001100
1110000111